12 13
0 0 0 0 0 0 0 0 0 0 0 0
3 0 0 2 0 1 0 3 0 0 0 3
0 1 0 0 0 0 1 0 0 12 1 0
0 0 0 4 5 6 0 0 0 0 0 0
0 0 7 8 8 9 1 0 2 0 0 0
0 0 0 1 0 1 3 0 12 0 0 0
0 0 0 0 0 0 0 0 0 1 0 0
0 2 0 0 12 1 0 4 5 5 6 0
0 0 0 3 0 0 4 10 10 11 9 0
0 0 0 1 1 0 7 10 10 9 0 0
0 0 1 1 0 0 0 7 8 9 0 0
0 0 0 0 0 12 0 0 0 0 0 0
0 0 3 0 0 0 2 0 0 0 0 0
